##################################################
#                                                #
#         @                                      #
#                                                #
#                              H                 #
#                         #                      #
#       ###################                      #
#       #                 #    M                 #
#   S   #                 #                      #
#       ####   ###### #####                      #
#       #        #        #                      #
#       #        #        #                      #
#       #        #        #                      #
#       ############### ###############          #
#                         #                      #
#                         #                      #
#                         #                      #
#                         #                      #
#                                                #
##################################################
